"filename", "language", "TypeScript", "HTML", "CSS", "comment", "blank", "total"
"d:\FIXXUP\Angular-FIXXP-\src\app\Authguard\authentication.guard.spec.ts", "TypeScript", 12, 0, 0, 0, 5, 17
"d:\FIXXUP\Angular-FIXXP-\src\app\Authguard\authentication.guard.ts", "TypeScript", 20, 0, 0, 0, 9, 29
"d:\FIXXUP\Angular-FIXXP-\src\app\Authguard\authguard-services.service.spec.ts", "TypeScript", 12, 0, 0, 0, 5, 17
"d:\FIXXUP\Angular-FIXXP-\src\app\Authguard\authguard-services.service.ts", "TypeScript", 10, 0, 0, 0, 3, 13
"d:\FIXXUP\Angular-FIXXP-\src\app\Authguard\external-quard.guard.spec.ts", "TypeScript", 12, 0, 0, 0, 5, 17
"d:\FIXXUP\Angular-FIXXP-\src\app\Authguard\external-quard.guard.ts", "TypeScript", 20, 0, 0, 0, 6, 26
"d:\FIXXUP\Angular-FIXXP-\src\app\abs\abs.component.css", "CSS", 0, 0, 0, 0, 1, 1
"d:\FIXXUP\Angular-FIXXP-\src\app\abs\abs.component.html", "HTML", 0, 36, 0, 0, 4, 40
"d:\FIXXUP\Angular-FIXXP-\src\app\abs\abs.component.spec.ts", "TypeScript", 18, 0, 0, 0, 6, 24
"d:\FIXXUP\Angular-FIXXP-\src\app\abs\abs.component.ts", "TypeScript", 137, 0, 0, 0, 19, 156
"d:\FIXXUP\Angular-FIXXP-\src\app\add-charges\add-charges.component.css", "CSS", 0, 0, 475, 2, 120, 597
"d:\FIXXUP\Angular-FIXXP-\src\app\add-charges\add-charges.component.html", "HTML", 0, 368, 0, 18, 15, 401
"d:\FIXXUP\Angular-FIXXP-\src\app\add-charges\add-charges.component.spec.ts", "TypeScript", 18, 0, 0, 0, 6, 24
"d:\FIXXUP\Angular-FIXXP-\src\app\add-charges\add-charges.component.ts", "TypeScript", 142, 0, 0, 0, 19, 161
"d:\FIXXUP\Angular-FIXXP-\src\app\add-stamp-paper\add-stamp-paper.component.css", "CSS", 0, 0, 475, 2, 121, 598
"d:\FIXXUP\Angular-FIXXP-\src\app\add-stamp-paper\add-stamp-paper.component.html", "HTML", 0, 314, 0, 12, 16, 342
"d:\FIXXUP\Angular-FIXXP-\src\app\add-stamp-paper\add-stamp-paper.component.spec.ts", "TypeScript", 18, 0, 0, 0, 6, 24
"d:\FIXXUP\Angular-FIXXP-\src\app\add-stamp-paper\add-stamp-paper.component.ts", "TypeScript", 139, 0, 0, 0, 16, 155
"d:\FIXXUP\Angular-FIXXP-\src\app\add-visitors-type\add-visitors-type.component.css", "CSS", 0, 0, 259, 0, 37, 296
"d:\FIXXUP\Angular-FIXXP-\src\app\add-visitors-type\add-visitors-type.component.html", "HTML", 0, 480, 0, 10, 22, 512
"d:\FIXXUP\Angular-FIXXP-\src\app\add-visitors-type\add-visitors-type.component.spec.ts", "TypeScript", 18, 0, 0, 0, 6, 24
"d:\FIXXUP\Angular-FIXXP-\src\app\add-visitors-type\add-visitors-type.component.ts", "TypeScript", 161, 0, 0, 0, 12, 173
"d:\FIXXUP\Angular-FIXXP-\src\app\addcity\addcity.component.css", "CSS", 0, 0, 258, 0, 37, 295
"d:\FIXXUP\Angular-FIXXP-\src\app\addcity\addcity.component.html", "HTML", 0, 489, 0, 10, 22, 521
"d:\FIXXUP\Angular-FIXXP-\src\app\addcity\addcity.component.spec.ts", "TypeScript", 18, 0, 0, 0, 6, 24
"d:\FIXXUP\Angular-FIXXP-\src\app\addcity\addcity.component.ts", "TypeScript", 174, 0, 0, 0, 26, 200
"d:\FIXXUP\Angular-FIXXP-\src\app\adddaily-helper-category\adddaily-helper-category.component.css", "CSS", 0, 0, 259, 0, 37, 296
"d:\FIXXUP\Angular-FIXXP-\src\app\adddaily-helper-category\adddaily-helper-category.component.html", "HTML", 0, 480, 0, 10, 22, 512
"d:\FIXXUP\Angular-FIXXP-\src\app\adddaily-helper-category\adddaily-helper-category.component.spec.ts", "TypeScript", 18, 0, 0, 0, 6, 24
"d:\FIXXUP\Angular-FIXXP-\src\app\adddaily-helper-category\adddaily-helper-category.component.ts", "TypeScript", 157, 0, 0, 0, 20, 177
"d:\FIXXUP\Angular-FIXXP-\src\app\addmanager\addmanager.component.css", "CSS", 0, 0, 259, 0, 37, 296
"d:\FIXXUP\Angular-FIXXP-\src\app\addmanager\addmanager.component.html", "HTML", 0, 505, 0, 10, 22, 537
"d:\FIXXUP\Angular-FIXXP-\src\app\addmanager\addmanager.component.spec.ts", "TypeScript", 18, 0, 0, 0, 6, 24
"d:\FIXXUP\Angular-FIXXP-\src\app\addmanager\addmanager.component.ts", "TypeScript", 203, 0, 0, 0, 28, 231
"d:\FIXXUP\Angular-FIXXP-\src\app\addmanagerbankdetail\addmanagerbankdetail.component.css", "CSS", 0, 0, 414, 519, 95, 1028
"d:\FIXXUP\Angular-FIXXP-\src\app\addmanagerbankdetail\addmanagerbankdetail.component.html", "HTML", 0, 160, 0, 182, 35, 377
"d:\FIXXUP\Angular-FIXXP-\src\app\addmanagerbankdetail\addmanagerbankdetail.component.spec.ts", "TypeScript", 18, 0, 0, 0, 6, 24
"d:\FIXXUP\Angular-FIXXP-\src\app\addmanagerbankdetail\addmanagerbankdetail.component.ts", "TypeScript", 138, 0, 0, 0, 22, 160
"d:\FIXXUP\Angular-FIXXP-\src\app\addpincode\addpincode.component.css", "CSS", 0, 0, 252, 0, 37, 289
"d:\FIXXUP\Angular-FIXXP-\src\app\addpincode\addpincode.component.html", "HTML", 0, 500, 0, 10, 21, 531
"d:\FIXXUP\Angular-FIXXP-\src\app\addpincode\addpincode.component.spec.ts", "TypeScript", 18, 0, 0, 0, 6, 24
"d:\FIXXUP\Angular-FIXXP-\src\app\addpincode\addpincode.component.ts", "TypeScript", 184, 0, 0, 0, 27, 211
"d:\FIXXUP\Angular-FIXXP-\src\app\addraised-complaint\addraised-complaint.component.css", "CSS", 0, 0, 258, 0, 37, 295
"d:\FIXXUP\Angular-FIXXP-\src\app\addraised-complaint\addraised-complaint.component.html", "HTML", 0, 480, 0, 10, 22, 512
"d:\FIXXUP\Angular-FIXXP-\src\app\addraised-complaint\addraised-complaint.component.spec.ts", "TypeScript", 18, 0, 0, 0, 6, 24
"d:\FIXXUP\Angular-FIXXP-\src\app\addraised-complaint\addraised-complaint.component.ts", "TypeScript", 157, 0, 0, 0, 20, 177
"d:\FIXXUP\Angular-FIXXP-\src\app\addrole\addrole.component.css", "CSS", 0, 0, 258, 0, 37, 295
"d:\FIXXUP\Angular-FIXXP-\src\app\addrole\addrole.component.html", "HTML", 0, 479, 0, 14, 21, 514
"d:\FIXXUP\Angular-FIXXP-\src\app\addrole\addrole.component.spec.ts", "TypeScript", 18, 0, 0, 0, 6, 24
"d:\FIXXUP\Angular-FIXXP-\src\app\addrole\addrole.component.ts", "TypeScript", 162, 0, 0, 0, 10, 172
"d:\FIXXUP\Angular-FIXXP-\src\app\addsociety\addsociety.component.css", "CSS", 0, 0, 259, 0, 37, 296
"d:\FIXXUP\Angular-FIXXP-\src\app\addsociety\addsociety.component.html", "HTML", 0, 519, 0, 10, 23, 552
"d:\FIXXUP\Angular-FIXXP-\src\app\addsociety\addsociety.component.spec.ts", "TypeScript", 18, 0, 0, 0, 6, 24
"d:\FIXXUP\Angular-FIXXP-\src\app\addsociety\addsociety.component.ts", "TypeScript", 217, 0, 0, 0, 34, 251
"d:\FIXXUP\Angular-FIXXP-\src\app\addstate\addstate.component.css", "CSS", 0, 0, 258, 0, 37, 295
"d:\FIXXUP\Angular-FIXXP-\src\app\addstate\addstate.component.html", "HTML", 0, 480, 0, 10, 22, 512
"d:\FIXXUP\Angular-FIXXP-\src\app\addstate\addstate.component.spec.ts", "TypeScript", 18, 0, 0, 0, 6, 24
"d:\FIXXUP\Angular-FIXXP-\src\app\addstate\addstate.component.ts", "TypeScript", 156, 0, 0, 0, 16, 172
"d:\FIXXUP\Angular-FIXXP-\src\app\adduser\adduser.component.css", "CSS", 0, 0, 149, 1, 1, 151
"d:\FIXXUP\Angular-FIXXP-\src\app\adduser\adduser.component.html", "HTML", 0, 82, 0, 2, 0, 84
"d:\FIXXUP\Angular-FIXXP-\src\app\adduser\adduser.component.spec.ts", "TypeScript", 18, 0, 0, 0, 6, 24
"d:\FIXXUP\Angular-FIXXP-\src\app\adduser\adduser.component.ts", "TypeScript", 8, 0, 0, 0, 3, 11
"d:\FIXXUP\Angular-FIXXP-\src\app\addvisitor\addvisitor.component.css", "CSS", 0, 0, 258, 0, 38, 296
"d:\FIXXUP\Angular-FIXXP-\src\app\addvisitor\addvisitor.component.html", "HTML", 0, 475, 0, 10, 22, 507
"d:\FIXXUP\Angular-FIXXP-\src\app\addvisitor\addvisitor.component.spec.ts", "TypeScript", 18, 0, 0, 0, 6, 24
"d:\FIXXUP\Angular-FIXXP-\src\app\addvisitor\addvisitor.component.ts", "TypeScript", 162, 0, 0, 0, 16, 178
"d:\FIXXUP\Angular-FIXXP-\src\app\admin-profile\admin-profile.component.css", "CSS", 0, 0, 259, 0, 37, 296
"d:\FIXXUP\Angular-FIXXP-\src\app\admin-profile\admin-profile.component.html", "HTML", 0, 491, 0, 10, 23, 524
"d:\FIXXUP\Angular-FIXXP-\src\app\admin-profile\admin-profile.component.spec.ts", "TypeScript", 18, 0, 0, 0, 6, 24
"d:\FIXXUP\Angular-FIXXP-\src\app\admin-profile\admin-profile.component.ts", "TypeScript", 167, 0, 0, 0, 30, 197
"d:\FIXXUP\Angular-FIXXP-\src\app\adminlogin\adminlogin.component.css", "CSS", 0, 0, 261, 0, 56, 317
"d:\FIXXUP\Angular-FIXXP-\src\app\adminlogin\adminlogin.component.html", "HTML", 0, 203, 0, 107, 10, 320
"d:\FIXXUP\Angular-FIXXP-\src\app\adminlogin\adminlogin.component.spec.ts", "TypeScript", 18, 0, 0, 0, 6, 24
"d:\FIXXUP\Angular-FIXXP-\src\app\adminlogin\adminlogin.component.ts", "TypeScript", 52, 0, 0, 1, 10, 63
"d:\FIXXUP\Angular-FIXXP-\src\app\agnys\agnys.component.css", "CSS", 0, 0, 6, 0, 2, 8
"d:\FIXXUP\Angular-FIXXP-\src\app\agnys\agnys.component.html", "HTML", 0, 0, 0, 18, 0, 18
"d:\FIXXUP\Angular-FIXXP-\src\app\agnys\agnys.component.spec.ts", "TypeScript", 18, 0, 0, 0, 6, 24
"d:\FIXXUP\Angular-FIXXP-\src\app\agnys\agnys.component.ts", "TypeScript", 14, 0, 0, 28, 20, 62
"d:\FIXXUP\Angular-FIXXP-\src\app\agnys\models\society.model.ts", "TypeScript", 7, 0, 0, 0, 2, 9
"d:\FIXXUP\Angular-FIXXP-\src\app\all-admin\all-admin.component.css", "CSS", 0, 0, 188, 866, 21, 1075
"d:\FIXXUP\Angular-FIXXP-\src\app\all-admin\all-admin.component.html", "HTML", 0, 592, 0, 11, 19, 622
"d:\FIXXUP\Angular-FIXXP-\src\app\all-admin\all-admin.component.spec.ts", "TypeScript", 18, 0, 0, 0, 6, 24
"d:\FIXXUP\Angular-FIXXP-\src\app\all-admin\all-admin.component.ts", "TypeScript", 153, 0, 0, 0, 12, 165
"d:\FIXXUP\Angular-FIXXP-\src\app\all-charges\all-charges.component.css", "CSS", 0, 0, 355, 465, 93, 913
"d:\FIXXUP\Angular-FIXXP-\src\app\all-charges\all-charges.component.html", "HTML", 0, 393, 0, 0, 16, 409
"d:\FIXXUP\Angular-FIXXP-\src\app\all-charges\all-charges.component.spec.ts", "TypeScript", 18, 0, 0, 0, 6, 24
"d:\FIXXUP\Angular-FIXXP-\src\app\all-charges\all-charges.component.ts", "TypeScript", 133, 0, 0, 0, 12, 145
"d:\FIXXUP\Angular-FIXXP-\src\app\all-users-kyc-docs\all-users-kyc-docs.component.css", "CSS", 0, 0, 0, 0, 1, 1
"d:\FIXXUP\Angular-FIXXP-\src\app\all-users-kyc-docs\all-users-kyc-docs.component.html", "HTML", 0, 1, 0, 0, 1, 2
"d:\FIXXUP\Angular-FIXXP-\src\app\all-users-kyc-docs\all-users-kyc-docs.component.spec.ts", "TypeScript", 18, 0, 0, 0, 6, 24
"d:\FIXXUP\Angular-FIXXP-\src\app\all-users-kyc-docs\all-users-kyc-docs.component.ts", "TypeScript", 8, 0, 0, 0, 3, 11
"d:\FIXXUP\Angular-FIXXP-\src\app\all-users-kyc\all-users-kyc.component.css", "CSS", 0, 0, 194, 7, 44, 245
"d:\FIXXUP\Angular-FIXXP-\src\app\all-users-kyc\all-users-kyc.component.html", "HTML", 0, 44, 0, 0, 16, 60
"d:\FIXXUP\Angular-FIXXP-\src\app\all-users-kyc\all-users-kyc.component.spec.ts", "TypeScript", 18, 0, 0, 0, 6, 24
"d:\FIXXUP\Angular-FIXXP-\src\app\all-users-kyc\all-users-kyc.component.ts", "TypeScript", 39, 0, 0, 0, 14, 53
"d:\FIXXUP\Angular-FIXXP-\src\app\all-visitors-type\all-visitors-type.component.css", "CSS", 0, 0, 171, 866, 16, 1053
"d:\FIXXUP\Angular-FIXXP-\src\app\all-visitors-type\all-visitors-type.component.html", "HTML", 0, 546, 0, 611, 33, 1190
"d:\FIXXUP\Angular-FIXXP-\src\app\all-visitors-type\all-visitors-type.component.spec.ts", "TypeScript", 18, 0, 0, 0, 6, 24
"d:\FIXXUP\Angular-FIXXP-\src\app\all-visitors-type\all-visitors-type.component.ts", "TypeScript", 158, 0, 0, 0, 18, 176
"d:\FIXXUP\Angular-FIXXP-\src\app\all-worker-transaction\all-worker-transaction.component.css", "CSS", 0, 0, 187, 878, 24, 1089
"d:\FIXXUP\Angular-FIXXP-\src\app\all-worker-transaction\all-worker-transaction.component.html", "HTML", 0, 567, 0, 17, 36, 620
"d:\FIXXUP\Angular-FIXXP-\src\app\all-worker-transaction\all-worker-transaction.component.spec.ts", "TypeScript", 18, 0, 0, 0, 6, 24
"d:\FIXXUP\Angular-FIXXP-\src\app\all-worker-transaction\all-worker-transaction.component.ts", "TypeScript", 149, 0, 0, 6, 15, 170
"d:\FIXXUP\Angular-FIXXP-\src\app\app-routing.module.ts", "TypeScript", 657, 0, 0, 4, 21, 682
"d:\FIXXUP\Angular-FIXXP-\src\app\app.component.css", "CSS", 0, 0, 0, 0, 1, 1
"d:\FIXXUP\Angular-FIXXP-\src\app\app.component.html", "HTML", 0, 1, 0, 0, 1, 2
"d:\FIXXUP\Angular-FIXXP-\src\app\app.component.spec.ts", "TypeScript", 31, 0, 0, 0, 5, 36
"d:\FIXXUP\Angular-FIXXP-\src\app\app.component.ts", "TypeScript", 19, 0, 0, 1, 5, 25
"d:\FIXXUP\Angular-FIXXP-\src\app\app.module.ts", "TypeScript", 288, 0, 0, 0, 15, 303
"d:\FIXXUP\Angular-FIXXP-\src\app\block\block.component.css", "CSS", 0, 0, 171, 866, 16, 1053
"d:\FIXXUP\Angular-FIXXP-\src\app\block\block.component.html", "HTML", 0, 515, 0, 22, 40, 577
"d:\FIXXUP\Angular-FIXXP-\src\app\block\block.component.spec.ts", "TypeScript", 18, 0, 0, 0, 6, 24
"d:\FIXXUP\Angular-FIXXP-\src\app\block\block.component.ts", "TypeScript", 157, 0, 0, 0, 18, 175
"d:\FIXXUP\Angular-FIXXP-\src\app\changepassword\changepassword.component.css", "CSS", 0, 0, 330, 3, 68, 401
"d:\FIXXUP\Angular-FIXXP-\src\app\changepassword\changepassword.component.html", "HTML", 0, 44, 0, 0, 10, 54
"d:\FIXXUP\Angular-FIXXP-\src\app\changepassword\changepassword.component.spec.ts", "TypeScript", 18, 0, 0, 0, 6, 24
"d:\FIXXUP\Angular-FIXXP-\src\app\changepassword\changepassword.component.ts", "TypeScript", 42, 0, 0, 0, 9, 51
"d:\FIXXUP\Angular-FIXXP-\src\app\check-society-logo\check-society-logo.component.css", "CSS", 0, 0, 0, 0, 1, 1
"d:\FIXXUP\Angular-FIXXP-\src\app\check-society-logo\check-society-logo.component.html", "HTML", 0, 1, 0, 0, 0, 1
"d:\FIXXUP\Angular-FIXXP-\src\app\check-society-logo\check-society-logo.component.spec.ts", "TypeScript", 18, 0, 0, 0, 6, 24
"d:\FIXXUP\Angular-FIXXP-\src\app\check-society-logo\check-society-logo.component.ts", "TypeScript", 34, 0, 0, 0, 14, 48
"d:\FIXXUP\Angular-FIXXP-\src\app\checkvisitorsimage\checkvisitorsimage.component.css", "CSS", 0, 0, 0, 0, 1, 1
"d:\FIXXUP\Angular-FIXXP-\src\app\checkvisitorsimage\checkvisitorsimage.component.html", "HTML", 0, 1, 0, 0, 0, 1
"d:\FIXXUP\Angular-FIXXP-\src\app\checkvisitorsimage\checkvisitorsimage.component.spec.ts", "TypeScript", 18, 0, 0, 0, 6, 24
"d:\FIXXUP\Angular-FIXXP-\src\app\checkvisitorsimage\checkvisitorsimage.component.ts", "TypeScript", 34, 0, 0, 0, 15, 49
"d:\FIXXUP\Angular-FIXXP-\src\app\daily-helper-category\daily-helper-category.component.css", "CSS", 0, 0, 171, 866, 16, 1053
"d:\FIXXUP\Angular-FIXXP-\src\app\daily-helper-category\daily-helper-category.component.html", "HTML", 0, 544, 0, 10, 29, 583
"d:\FIXXUP\Angular-FIXXP-\src\app\daily-helper-category\daily-helper-category.component.spec.ts", "TypeScript", 18, 0, 0, 0, 6, 24
"d:\FIXXUP\Angular-FIXXP-\src\app\daily-helper-category\daily-helper-category.component.ts", "TypeScript", 165, 0, 0, 0, 19, 184
"d:\FIXXUP\Angular-FIXXP-\src\app\daily-helpers-kyc\daily-helpers-kyc.component.css", "CSS", 0, 0, 255, 7, 51, 313
"d:\FIXXUP\Angular-FIXXP-\src\app\daily-helpers-kyc\daily-helpers-kyc.component.html", "HTML", 0, 59, 0, 38, 18, 115
"d:\FIXXUP\Angular-FIXXP-\src\app\daily-helpers-kyc\daily-helpers-kyc.component.spec.ts", "TypeScript", 18, 0, 0, 0, 6, 24
"d:\FIXXUP\Angular-FIXXP-\src\app\daily-helpers-kyc\daily-helpers-kyc.component.ts", "TypeScript", 40, 0, 0, 0, 14, 54
"d:\FIXXUP\Angular-FIXXP-\src\app\dailyHelpers Service\dailyhelperskyc.service.ts", "TypeScript", 7, 0, 0, 0, 3, 10
"d:\FIXXUP\Angular-FIXXP-\src\app\dashboard\dashboard.component.css", "CSS", 0, 0, 171, 866, 16, 1053
"d:\FIXXUP\Angular-FIXXP-\src\app\dashboard\dashboard.component.html", "HTML", 0, 650, 0, 9, 13, 672
"d:\FIXXUP\Angular-FIXXP-\src\app\dashboard\dashboard.component.spec.ts", "TypeScript", 18, 0, 0, 0, 6, 24
"d:\FIXXUP\Angular-FIXXP-\src\app\dashboard\dashboard.component.ts", "TypeScript", 232, 0, 0, 0, 21, 253
"d:\FIXXUP\Angular-FIXXP-\src\app\due-amount\due-amount.component.css", "CSS", 0, 0, 171, 866, 16, 1053
"d:\FIXXUP\Angular-FIXXP-\src\app\due-amount\due-amount.component.html", "HTML", 0, 575, 0, 618, 28, 1221
"d:\FIXXUP\Angular-FIXXP-\src\app\due-amount\due-amount.component.spec.ts", "TypeScript", 18, 0, 0, 0, 6, 24
"d:\FIXXUP\Angular-FIXXP-\src\app\due-amount\due-amount.component.ts", "TypeScript", 171, 0, 0, 0, 23, 194
"d:\FIXXUP\Angular-FIXXP-\src\app\edit-charges\edit-charges.component.css", "CSS", 0, 0, 475, 2, 120, 597
"d:\FIXXUP\Angular-FIXXP-\src\app\edit-charges\edit-charges.component.html", "HTML", 0, 369, 0, 18, 14, 401
"d:\FIXXUP\Angular-FIXXP-\src\app\edit-charges\edit-charges.component.spec.ts", "TypeScript", 18, 0, 0, 0, 6, 24
"d:\FIXXUP\Angular-FIXXP-\src\app\edit-charges\edit-charges.component.ts", "TypeScript", 146, 0, 0, 0, 21, 167
"d:\FIXXUP\Angular-FIXXP-\src\app\edit-city\edit-city.component.css", "CSS", 0, 0, 326, 393, 88, 807
"d:\FIXXUP\Angular-FIXXP-\src\app\edit-city\edit-city.component.html", "HTML", 0, 242, 0, 45, 31, 318
"d:\FIXXUP\Angular-FIXXP-\src\app\edit-city\edit-city.component.spec.ts", "TypeScript", 18, 0, 0, 0, 6, 24
"d:\FIXXUP\Angular-FIXXP-\src\app\edit-city\edit-city.component.ts", "TypeScript", 120, 0, 0, 0, 9, 129
"d:\FIXXUP\Angular-FIXXP-\src\app\edit-daily-helpes\edit-daily-helpes.component.css", "CSS", 0, 0, 385, 377, 100, 862
"d:\FIXXUP\Angular-FIXXP-\src\app\edit-daily-helpes\edit-daily-helpes.component.html", "HTML", 0, 188, 0, 154, 44, 386
"d:\FIXXUP\Angular-FIXXP-\src\app\edit-daily-helpes\edit-daily-helpes.component.spec.ts", "TypeScript", 18, 0, 0, 0, 6, 24
"d:\FIXXUP\Angular-FIXXP-\src\app\edit-daily-helpes\edit-daily-helpes.component.ts", "TypeScript", 129, 0, 0, 1, 13, 143
"d:\FIXXUP\Angular-FIXXP-\src\app\edit-manager\edit-manager.component.css", "CSS", 0, 0, 475, 2, 120, 597
"d:\FIXXUP\Angular-FIXXP-\src\app\edit-manager\edit-manager.component.html", "HTML", 0, 155, 0, 80, 51, 286
"d:\FIXXUP\Angular-FIXXP-\src\app\edit-manager\edit-manager.component.spec.ts", "TypeScript", 18, 0, 0, 0, 6, 24
"d:\FIXXUP\Angular-FIXXP-\src\app\edit-manager\edit-manager.component.ts", "TypeScript", 174, 0, 0, 0, 23, 197
"d:\FIXXUP\Angular-FIXXP-\src\app\edit-pincode\edit-pincode.component.css", "CSS", 0, 0, 355, 383, 86, 824
"d:\FIXXUP\Angular-FIXXP-\src\app\edit-pincode\edit-pincode.component.html", "HTML", 0, 208, 0, 233, 44, 485
"d:\FIXXUP\Angular-FIXXP-\src\app\edit-pincode\edit-pincode.component.spec.ts", "TypeScript", 18, 0, 0, 0, 6, 24
"d:\FIXXUP\Angular-FIXXP-\src\app\edit-pincode\edit-pincode.component.ts", "TypeScript", 143, 0, 0, 0, 22, 165
"d:\FIXXUP\Angular-FIXXP-\src\app\edit-profile\edit-profile.component.css", "CSS", 0, 0, 332, 375, 87, 794
"d:\FIXXUP\Angular-FIXXP-\src\app\edit-profile\edit-profile.component.html", "HTML", 0, 212, 0, 2, 42, 256
"d:\FIXXUP\Angular-FIXXP-\src\app\edit-profile\edit-profile.component.spec.ts", "TypeScript", 18, 0, 0, 0, 6, 24
"d:\FIXXUP\Angular-FIXXP-\src\app\edit-profile\edit-profile.component.ts", "TypeScript", 129, 0, 0, 0, 26, 155
"d:\FIXXUP\Angular-FIXXP-\src\app\edit-role\edit-role.component.css", "CSS", 0, 0, 405, 389, 93, 887
"d:\FIXXUP\Angular-FIXXP-\src\app\edit-role\edit-role.component.html", "HTML", 0, 185, 0, 155, 63, 403
"d:\FIXXUP\Angular-FIXXP-\src\app\edit-role\edit-role.component.spec.ts", "TypeScript", 18, 0, 0, 0, 6, 24
"d:\FIXXUP\Angular-FIXXP-\src\app\edit-role\edit-role.component.ts", "TypeScript", 162, 0, 0, 0, 14, 176
"d:\FIXXUP\Angular-FIXXP-\src\app\edit-society\edit-society.component.css", "CSS", 0, 0, 347, 490, 78, 915
"d:\FIXXUP\Angular-FIXXP-\src\app\edit-society\edit-society.component.html", "HTML", 0, 397, 0, 0, 16, 413
"d:\FIXXUP\Angular-FIXXP-\src\app\edit-society\edit-society.component.spec.ts", "TypeScript", 18, 0, 0, 0, 6, 24
"d:\FIXXUP\Angular-FIXXP-\src\app\edit-society\edit-society.component.ts", "TypeScript", 143, 0, 0, 0, 18, 161
"d:\FIXXUP\Angular-FIXXP-\src\app\edit-stamp-paper\edit-stamp-paper.component.css", "CSS", 0, 0, 475, 2, 120, 597
"d:\FIXXUP\Angular-FIXXP-\src\app\edit-stamp-paper\edit-stamp-paper.component.html", "HTML", 0, 314, 0, 12, 16, 342
"d:\FIXXUP\Angular-FIXXP-\src\app\edit-stamp-paper\edit-stamp-paper.component.spec.ts", "TypeScript", 18, 0, 0, 0, 6, 24
"d:\FIXXUP\Angular-FIXXP-\src\app\edit-stamp-paper\edit-stamp-paper.component.ts", "TypeScript", 141, 0, 0, 0, 18, 159
"d:\FIXXUP\Angular-FIXXP-\src\app\edit-state\edit-state.component.css", "CSS", 0, 0, 330, 377, 81, 788
"d:\FIXXUP\Angular-FIXXP-\src\app\edit-state\edit-state.component.html", "HTML", 0, 188, 0, 148, 43, 379
"d:\FIXXUP\Angular-FIXXP-\src\app\edit-state\edit-state.component.spec.ts", "TypeScript", 18, 0, 0, 0, 6, 24
"d:\FIXXUP\Angular-FIXXP-\src\app\edit-state\edit-state.component.ts", "TypeScript", 125, 0, 0, 0, 12, 137
"d:\FIXXUP\Angular-FIXXP-\src\app\edit-visitor-category\edit-visitor-category.component.css", "CSS", 0, 0, 348, 378, 79, 805
"d:\FIXXUP\Angular-FIXXP-\src\app\edit-visitor-category\edit-visitor-category.component.html", "HTML", 0, 97, 0, 143, 42, 282
"d:\FIXXUP\Angular-FIXXP-\src\app\edit-visitor-category\edit-visitor-category.component.spec.ts", "TypeScript", 18, 0, 0, 0, 6, 24
"d:\FIXXUP\Angular-FIXXP-\src\app\edit-visitor-category\edit-visitor-category.component.ts", "TypeScript", 123, 0, 0, 0, 10, 133
"d:\FIXXUP\Angular-FIXXP-\src\app\editraised-complaint\editraised-complaint.component.css", "CSS", 0, 0, 330, 0, 83, 413
"d:\FIXXUP\Angular-FIXXP-\src\app\editraised-complaint\editraised-complaint.component.html", "HTML", 0, 188, 0, 150, 44, 382
"d:\FIXXUP\Angular-FIXXP-\src\app\editraised-complaint\editraised-complaint.component.spec.ts", "TypeScript", 18, 0, 0, 0, 6, 24
"d:\FIXXUP\Angular-FIXXP-\src\app\editraised-complaint\editraised-complaint.component.ts", "TypeScript", 127, 0, 0, 0, 12, 139
"d:\FIXXUP\Angular-FIXXP-\src\app\flat-user-kyc\flat-user-kyc.component.css", "CSS", 0, 0, 0, 0, 1, 1
"d:\FIXXUP\Angular-FIXXP-\src\app\flat-user-kyc\flat-user-kyc.component.html", "HTML", 0, 1, 0, 0, 0, 1
"d:\FIXXUP\Angular-FIXXP-\src\app\flat-user-kyc\flat-user-kyc.component.spec.ts", "TypeScript", 18, 0, 0, 0, 6, 24
"d:\FIXXUP\Angular-FIXXP-\src\app\flat-user-kyc\flat-user-kyc.component.ts", "TypeScript", 34, 0, 0, 0, 12, 46
"d:\FIXXUP\Angular-FIXXP-\src\app\flats\flats.component.css", "CSS", 0, 0, 171, 866, 16, 1053
"d:\FIXXUP\Angular-FIXXP-\src\app\flats\flats.component.html", "HTML", 0, 318, 0, 23, 38, 379
"d:\FIXXUP\Angular-FIXXP-\src\app\flats\flats.component.spec.ts", "TypeScript", 18, 0, 0, 0, 6, 24
"d:\FIXXUP\Angular-FIXXP-\src\app\flats\flats.component.ts", "TypeScript", 148, 0, 0, 0, 9, 157
"d:\FIXXUP\Angular-FIXXP-\src\app\flatusers\flatusers.component.css", "CSS", 0, 0, 171, 866, 16, 1053
"d:\FIXXUP\Angular-FIXXP-\src\app\flatusers\flatusers.component.html", "HTML", 0, 508, 0, 23, 37, 568
"d:\FIXXUP\Angular-FIXXP-\src\app\flatusers\flatusers.component.spec.ts", "TypeScript", 18, 0, 0, 0, 6, 24
"d:\FIXXUP\Angular-FIXXP-\src\app\flatusers\flatusers.component.ts", "TypeScript", 139, 0, 0, 0, 14, 153
"d:\FIXXUP\Angular-FIXXP-\src\app\fp-verify-email\fp-verify-email.component.css", "CSS", 0, 0, 340, 1, 68, 409
"d:\FIXXUP\Angular-FIXXP-\src\app\fp-verify-email\fp-verify-email.component.html", "HTML", 0, 42, 0, 43, 7, 92
"d:\FIXXUP\Angular-FIXXP-\src\app\fp-verify-email\fp-verify-email.component.spec.ts", "TypeScript", 18, 0, 0, 0, 6, 24
"d:\FIXXUP\Angular-FIXXP-\src\app\fp-verify-email\fp-verify-email.component.ts", "TypeScript", 52, 0, 0, 0, 12, 64
"d:\FIXXUP\Angular-FIXXP-\src\app\fp-verify-otp\fp-verify-otp.component.css", "CSS", 0, 0, 335, 1, 66, 402
"d:\FIXXUP\Angular-FIXXP-\src\app\fp-verify-otp\fp-verify-otp.component.html", "HTML", 0, 56, 0, 50, 4, 110
"d:\FIXXUP\Angular-FIXXP-\src\app\fp-verify-otp\fp-verify-otp.component.spec.ts", "TypeScript", 18, 0, 0, 0, 6, 24
"d:\FIXXUP\Angular-FIXXP-\src\app\fp-verify-otp\fp-verify-otp.component.ts", "TypeScript", 54, 0, 0, 0, 9, 63
"d:\FIXXUP\Angular-FIXXP-\src\app\home-transaction\home-transaction.component.css", "CSS", 0, 0, 190, 866, 18, 1074
"d:\FIXXUP\Angular-FIXXP-\src\app\home-transaction\home-transaction.component.html", "HTML", 0, 565, 0, 17, 20, 602
"d:\FIXXUP\Angular-FIXXP-\src\app\home-transaction\home-transaction.component.spec.ts", "TypeScript", 18, 0, 0, 0, 6, 24
"d:\FIXXUP\Angular-FIXXP-\src\app\home-transaction\home-transaction.component.ts", "TypeScript", 146, 0, 0, 0, 14, 160
"d:\FIXXUP\Angular-FIXXP-\src\app\idbyusername\idbyusername.component.css", "CSS", 0, 0, 169, 7, 39, 215
"d:\FIXXUP\Angular-FIXXP-\src\app\idbyusername\idbyusername.component.html", "HTML", 0, 53, 0, 3, 15, 71
"d:\FIXXUP\Angular-FIXXP-\src\app\idbyusername\idbyusername.component.spec.ts", "TypeScript", 18, 0, 0, 0, 6, 24
"d:\FIXXUP\Angular-FIXXP-\src\app\idbyusername\idbyusername.component.ts", "TypeScript", 23, 0, 0, 0, 6, 29
"d:\FIXXUP\Angular-FIXXP-\src\app\invoice-pdf\invoice-pdf.component.css", "CSS", 0, 0, 0, 0, 1, 1
"d:\FIXXUP\Angular-FIXXP-\src\app\invoice-pdf\invoice-pdf.component.html", "HTML", 0, 1, 0, 0, 1, 2
"d:\FIXXUP\Angular-FIXXP-\src\app\invoice-pdf\invoice-pdf.component.spec.ts", "TypeScript", 18, 0, 0, 0, 6, 24
"d:\FIXXUP\Angular-FIXXP-\src\app\invoice-pdf\invoice-pdf.component.ts", "TypeScript", 8, 0, 0, 0, 4, 12
"d:\FIXXUP\Angular-FIXXP-\src\app\list-admin\list-admin.component.css", "CSS", 0, 0, 0, 0, 1, 1
"d:\FIXXUP\Angular-FIXXP-\src\app\list-admin\list-admin.component.html", "HTML", 0, 1, 0, 0, 1, 2
"d:\FIXXUP\Angular-FIXXP-\src\app\list-admin\list-admin.component.spec.ts", "TypeScript", 18, 0, 0, 0, 6, 24
"d:\FIXXUP\Angular-FIXXP-\src\app\list-admin\list-admin.component.ts", "TypeScript", 8, 0, 0, 0, 3, 11
"d:\FIXXUP\Angular-FIXXP-\src\app\listcity\listcity.component.css", "CSS", 0, 0, 176, 866, 17, 1059
"d:\FIXXUP\Angular-FIXXP-\src\app\listcity\listcity.component.html", "HTML", 0, 520, 0, 26, 37, 583
"d:\FIXXUP\Angular-FIXXP-\src\app\listcity\listcity.component.spec.ts", "TypeScript", 18, 0, 0, 0, 6, 24
"d:\FIXXUP\Angular-FIXXP-\src\app\listcity\listcity.component.ts", "TypeScript", 177, 0, 0, 9, 16, 202
"d:\FIXXUP\Angular-FIXXP-\src\app\listpincode\listpincode.component.css", "CSS", 0, 0, 176, 866, 17, 1059
"d:\FIXXUP\Angular-FIXXP-\src\app\listpincode\listpincode.component.html", "HTML", 0, 333, 0, 21, 40, 394
"d:\FIXXUP\Angular-FIXXP-\src\app\listpincode\listpincode.component.spec.ts", "TypeScript", 18, 0, 0, 0, 6, 24
"d:\FIXXUP\Angular-FIXXP-\src\app\listpincode\listpincode.component.ts", "TypeScript", 174, 0, 0, 6, 22, 202
"d:\FIXXUP\Angular-FIXXP-\src\app\liststate\liststate.component.css", "CSS", 0, 0, 348, 465, 93, 906
"d:\FIXXUP\Angular-FIXXP-\src\app\liststate\liststate.component.html", "HTML", 0, 167, 0, 4, 39, 210
"d:\FIXXUP\Angular-FIXXP-\src\app\liststate\liststate.component.spec.ts", "TypeScript", 18, 0, 0, 0, 6, 24
"d:\FIXXUP\Angular-FIXXP-\src\app\liststate\liststate.component.ts", "TypeScript", 135, 0, 0, 1, 13, 149
"d:\FIXXUP\Angular-FIXXP-\src\app\login\login.component.css", "CSS", 0, 0, 169, 13, 25, 207
"d:\FIXXUP\Angular-FIXXP-\src\app\login\login.component.html", "HTML", 0, 77, 0, 1, 10, 88
"d:\FIXXUP\Angular-FIXXP-\src\app\login\login.component.spec.ts", "TypeScript", 18, 0, 0, 0, 6, 24
"d:\FIXXUP\Angular-FIXXP-\src\app\login\login.component.ts", "TypeScript", 38, 0, 0, 0, 10, 48
"d:\FIXXUP\Angular-FIXXP-\src\app\manager-kyc-approve\manager-kyc-approve.component.css", "CSS", 0, 0, 5, 0, 1, 6
"d:\FIXXUP\Angular-FIXXP-\src\app\manager-kyc-approve\manager-kyc-approve.component.html", "HTML", 0, 38, 0, 26, 8, 72
"d:\FIXXUP\Angular-FIXXP-\src\app\manager-kyc-approve\manager-kyc-approve.component.spec.ts", "TypeScript", 18, 0, 0, 0, 6, 24
"d:\FIXXUP\Angular-FIXXP-\src\app\manager-kyc-approve\manager-kyc-approve.component.ts", "TypeScript", 41, 0, 0, 0, 7, 48
"d:\FIXXUP\Angular-FIXXP-\src\app\managers\managers.component.css", "CSS", 0, 0, 188, 1, 20, 209
"d:\FIXXUP\Angular-FIXXP-\src\app\managers\managers.component.html", "HTML", 0, 618, 0, 13, 23, 654
"d:\FIXXUP\Angular-FIXXP-\src\app\managers\managers.component.spec.ts", "TypeScript", 18, 0, 0, 0, 6, 24
"d:\FIXXUP\Angular-FIXXP-\src\app\managers\managers.component.ts", "TypeScript", 172, 0, 0, 0, 12, 184
"d:\FIXXUP\Angular-FIXXP-\src\app\models\society.model.ts", "TypeScript", 210, 0, 0, 0, 94, 304
"d:\FIXXUP\Angular-FIXXP-\src\app\pincode-status\pincode-status.component.css", "CSS", 0, 0, 0, 0, 1, 1
"d:\FIXXUP\Angular-FIXXP-\src\app\pincode-status\pincode-status.component.html", "HTML", 0, 24, 0, 0, 9, 33
"d:\FIXXUP\Angular-FIXXP-\src\app\pincode-status\pincode-status.component.spec.ts", "TypeScript", 18, 0, 0, 0, 6, 24
"d:\FIXXUP\Angular-FIXXP-\src\app\pincode-status\pincode-status.component.ts", "TypeScript", 34, 0, 0, 0, 11, 45
"d:\FIXXUP\Angular-FIXXP-\src\app\profile\profile.component.css", "CSS", 0, 0, 184, 7, 44, 235
"d:\FIXXUP\Angular-FIXXP-\src\app\profile\profile.component.html", "HTML", 0, 56, 0, 3, 18, 77
"d:\FIXXUP\Angular-FIXXP-\src\app\profile\profile.component.spec.ts", "TypeScript", 18, 0, 0, 0, 6, 24
"d:\FIXXUP\Angular-FIXXP-\src\app\profile\profile.component.ts", "TypeScript", 18, 0, 0, 0, 7, 25
"d:\FIXXUP\Angular-FIXXP-\src\app\raised-complaint\raised-complaint.component.css", "CSS", 0, 0, 171, 866, 16, 1053
"d:\FIXXUP\Angular-FIXXP-\src\app\raised-complaint\raised-complaint.component.html", "HTML", 0, 542, 0, 615, 33, 1190
"d:\FIXXUP\Angular-FIXXP-\src\app\raised-complaint\raised-complaint.component.spec.ts", "TypeScript", 18, 0, 0, 0, 6, 24
"d:\FIXXUP\Angular-FIXXP-\src\app\raised-complaint\raised-complaint.component.ts", "TypeScript", 162, 0, 0, 0, 17, 179
"d:\FIXXUP\Angular-FIXXP-\src\app\rent-pay\rent-pay.component.css", "CSS", 0, 0, 188, 1, 19, 208
"d:\FIXXUP\Angular-FIXXP-\src\app\rent-pay\rent-pay.component.html", "HTML", 0, 619, 0, 31, 21, 671
"d:\FIXXUP\Angular-FIXXP-\src\app\rent-pay\rent-pay.component.spec.ts", "TypeScript", 18, 0, 0, 0, 6, 24
"d:\FIXXUP\Angular-FIXXP-\src\app\rent-pay\rent-pay.component.ts", "TypeScript", 149, 0, 0, 6, 19, 174
"d:\FIXXUP\Angular-FIXXP-\src\app\resend-otp\resend-otp.component.css", "CSS", 0, 0, 0, 0, 1, 1
"d:\FIXXUP\Angular-FIXXP-\src\app\resend-otp\resend-otp.component.html", "HTML", 0, 1, 0, 0, 1, 2
"d:\FIXXUP\Angular-FIXXP-\src\app\resend-otp\resend-otp.component.spec.ts", "TypeScript", 18, 0, 0, 0, 6, 24
"d:\FIXXUP\Angular-FIXXP-\src\app\resend-otp\resend-otp.component.ts", "TypeScript", 8, 0, 0, 0, 3, 11
"d:\FIXXUP\Angular-FIXXP-\src\app\reset-password\reset-password.component.css", "CSS", 0, 0, 341, 1, 70, 412
"d:\FIXXUP\Angular-FIXXP-\src\app\reset-password\reset-password.component.html", "HTML", 0, 99, 0, 1, 5, 105
"d:\FIXXUP\Angular-FIXXP-\src\app\reset-password\reset-password.component.spec.ts", "TypeScript", 18, 0, 0, 0, 6, 24
"d:\FIXXUP\Angular-FIXXP-\src\app\reset-password\reset-password.component.ts", "TypeScript", 128, 0, 0, 0, 10, 138
"d:\FIXXUP\Angular-FIXXP-\src\app\rolelist\rolelist.component.css", "CSS", 0, 0, 171, 866, 16, 1053
"d:\FIXXUP\Angular-FIXXP-\src\app\rolelist\rolelist.component.html", "HTML", 0, 546, 0, 10, 28, 584
"d:\FIXXUP\Angular-FIXXP-\src\app\rolelist\rolelist.component.spec.ts", "TypeScript", 18, 0, 0, 0, 6, 24
"d:\FIXXUP\Angular-FIXXP-\src\app\rolelist\rolelist.component.ts", "TypeScript", 169, 0, 0, 0, 25, 194
"d:\FIXXUP\Angular-FIXXP-\src\app\security-guard-kyc\security-guard-kyc.component.css", "CSS", 0, 0, 194, 7, 44, 245
"d:\FIXXUP\Angular-FIXXP-\src\app\security-guard-kyc\security-guard-kyc.component.html", "HTML", 0, 32, 0, 0, 2, 34
"d:\FIXXUP\Angular-FIXXP-\src\app\security-guard-kyc\security-guard-kyc.component.spec.ts", "TypeScript", 18, 0, 0, 0, 6, 24
"d:\FIXXUP\Angular-FIXXP-\src\app\security-guard-kyc\security-guard-kyc.component.ts", "TypeScript", 18, 0, 0, 0, 7, 25
"d:\FIXXUP\Angular-FIXXP-\src\app\services\Daily Helpers\dailyhelpersview-kyc.service.ts", "TypeScript", 27, 0, 0, 0, 9, 36
"d:\FIXXUP\Angular-FIXXP-\src\app\services\Home Transaction\hometransactions.service.ts", "TypeScript", 27, 0, 0, 3, 14, 44
"d:\FIXXUP\Angular-FIXXP-\src\app\services\Invoice\invoice.service.ts", "TypeScript", 27, 0, 0, 2, 13, 42
"d:\FIXXUP\Angular-FIXXP-\src\app\services\Login Service\login.service.ts", "TypeScript", 883, 0, 0, 3, 184, 1070
"d:\FIXXUP\Angular-FIXXP-\src\app\services\Receipt PDF\receipt.service.ts", "TypeScript", 27, 0, 0, 3, 14, 44
"d:\FIXXUP\Angular-FIXXP-\src\app\services\Rental Agreement\rental.service.ts", "TypeScript", 27, 0, 0, 3, 12, 42
"d:\FIXXUP\Angular-FIXXP-\src\app\services\Security Worker Document\security-workers-doc.service.ts", "TypeScript", 27, 0, 0, 0, 10, 37
"d:\FIXXUP\Angular-FIXXP-\src\app\services\Service  Toggle\toggle-service.service.ts", "TypeScript", 27, 0, 0, 0, 9, 36
"d:\FIXXUP\Angular-FIXXP-\src\app\services\Society Logo\view-society-logo.service.ts", "TypeScript", 27, 0, 0, 2, 9, 38
"d:\FIXXUP\Angular-FIXXP-\src\app\services\Society Manager KYC\society-manager-kyc.service.spec.ts", "TypeScript", 12, 0, 0, 0, 5, 17
"d:\FIXXUP\Angular-FIXXP-\src\app\services\Society Manager KYC\society-manager-kyc.service.ts", "TypeScript", 27, 0, 0, 1, 10, 38
"d:\FIXXUP\Angular-FIXXP-\src\app\services\TIcket Worker Document\ticket-workers-doc.service.ts", "TypeScript", 27, 0, 0, 0, 9, 36
"d:\FIXXUP\Angular-FIXXP-\src\app\services\UserKyc\flat-user-kyc.service.ts", "TypeScript", 27, 0, 0, 1, 10, 38
"d:\FIXXUP\Angular-FIXXP-\src\app\services\VIsitors Image\visitors-images.service.ts", "TypeScript", 27, 0, 0, 3, 13, 43
"d:\FIXXUP\Angular-FIXXP-\src\app\services\promition service\image-promotion.service.ts", "TypeScript", 33, 0, 0, 1, 15, 49
"d:\FIXXUP\Angular-FIXXP-\src\app\services\society Upload Logo\society-upload-logo.service.ts", "TypeScript", 32, 0, 0, 1, 18, 51
"d:\FIXXUP\Angular-FIXXP-\src\app\settlement-update\settlement-update.component.css", "CSS", 0, 0, 326, 393, 88, 807
"d:\FIXXUP\Angular-FIXXP-\src\app\settlement-update\settlement-update.component.html", "HTML", 0, 348, 0, 45, 17, 410
"d:\FIXXUP\Angular-FIXXP-\src\app\settlement-update\settlement-update.component.spec.ts", "TypeScript", 18, 0, 0, 0, 6, 24
"d:\FIXXUP\Angular-FIXXP-\src\app\settlement-update\settlement-update.component.ts", "TypeScript", 132, 0, 0, 0, 25, 157
"d:\FIXXUP\Angular-FIXXP-\src\app\society-based-visitors\society-based-visitors.component.css", "CSS", 0, 0, 176, 867, 21, 1064
"d:\FIXXUP\Angular-FIXXP-\src\app\society-based-visitors\society-based-visitors.component.html", "HTML", 0, 553, 0, 613, 38, 1204
"d:\FIXXUP\Angular-FIXXP-\src\app\society-based-visitors\society-based-visitors.component.spec.ts", "TypeScript", 18, 0, 0, 0, 6, 24
"d:\FIXXUP\Angular-FIXXP-\src\app\society-based-visitors\society-based-visitors.component.ts", "TypeScript", 170, 0, 0, 0, 16, 186
"d:\FIXXUP\Angular-FIXXP-\src\app\society-daily-workers\society-daily-workers.component.css", "CSS", 0, 0, 176, 866, 17, 1059
"d:\FIXXUP\Angular-FIXXP-\src\app\society-daily-workers\society-daily-workers.component.html", "HTML", 0, 546, 0, 622, 44, 1212
"d:\FIXXUP\Angular-FIXXP-\src\app\society-daily-workers\society-daily-workers.component.spec.ts", "TypeScript", 18, 0, 0, 0, 6, 24
"d:\FIXXUP\Angular-FIXXP-\src\app\society-daily-workers\society-daily-workers.component.ts", "TypeScript", 162, 0, 0, 1, 14, 177
"d:\FIXXUP\Angular-FIXXP-\src\app\society-emergency-contact\society-emergency-contact.component.css", "CSS", 0, 0, 176, 866, 17, 1059
"d:\FIXXUP\Angular-FIXXP-\src\app\society-emergency-contact\society-emergency-contact.component.html", "HTML", 0, 531, 0, 622, 45, 1198
"d:\FIXXUP\Angular-FIXXP-\src\app\society-emergency-contact\society-emergency-contact.component.spec.ts", "TypeScript", 18, 0, 0, 0, 6, 24
"d:\FIXXUP\Angular-FIXXP-\src\app\society-emergency-contact\society-emergency-contact.component.ts", "TypeScript", 169, 0, 0, 0, 17, 186
"d:\FIXXUP\Angular-FIXXP-\src\app\society-promotions\society-promotions.component.css", "CSS", 0, 0, 259, 1, 37, 297
"d:\FIXXUP\Angular-FIXXP-\src\app\society-promotions\society-promotions.component.html", "HTML", 0, 491, 0, 11, 20, 522
"d:\FIXXUP\Angular-FIXXP-\src\app\society-promotions\society-promotions.component.spec.ts", "TypeScript", 18, 0, 0, 0, 6, 24
"d:\FIXXUP\Angular-FIXXP-\src\app\society-promotions\society-promotions.component.ts", "TypeScript", 190, 0, 0, 1, 26, 217
"d:\FIXXUP\Angular-FIXXP-\src\app\society-security-guard\society-security-guard.component.css", "CSS", 0, 0, 193, 1, 20, 214
"d:\FIXXUP\Angular-FIXXP-\src\app\society-security-guard\society-security-guard.component.html", "HTML", 0, 561, 0, 623, 40, 1224
"d:\FIXXUP\Angular-FIXXP-\src\app\society-security-guard\society-security-guard.component.spec.ts", "TypeScript", 18, 0, 0, 0, 6, 24
"d:\FIXXUP\Angular-FIXXP-\src\app\society-security-guard\society-security-guard.component.ts", "TypeScript", 180, 0, 0, 0, 17, 197
"d:\FIXXUP\Angular-FIXXP-\src\app\society-ticket-workers\society-ticket-workers.component.css", "CSS", 0, 0, 176, 867, 16, 1059
"d:\FIXXUP\Angular-FIXXP-\src\app\society-ticket-workers\society-ticket-workers.component.html", "HTML", 0, 552, 0, 21, 36, 609
"d:\FIXXUP\Angular-FIXXP-\src\app\society-ticket-workers\society-ticket-workers.component.spec.ts", "TypeScript", 18, 0, 0, 0, 6, 24
"d:\FIXXUP\Angular-FIXXP-\src\app\society-ticket-workers\society-ticket-workers.component.ts", "TypeScript", 158, 0, 0, 0, 14, 172
"d:\FIXXUP\Angular-FIXXP-\src\app\society-upload-logo\society-upload-logo.component.css", "CSS", 0, 0, 212, 41, 54, 307
"d:\FIXXUP\Angular-FIXXP-\src\app\society-upload-logo\society-upload-logo.component.html", "HTML", 0, 40, 0, 18, 22, 80
"d:\FIXXUP\Angular-FIXXP-\src\app\society-upload-logo\society-upload-logo.component.spec.ts", "TypeScript", 18, 0, 0, 0, 6, 24
"d:\FIXXUP\Angular-FIXXP-\src\app\society-upload-logo\society-upload-logo.component.ts", "TypeScript", 127, 0, 0, 0, 23, 150
"d:\FIXXUP\Angular-FIXXP-\src\app\society\society.component.css", "CSS", 0, 0, 171, 866, 16, 1053
"d:\FIXXUP\Angular-FIXXP-\src\app\society\society.component.html", "HTML", 0, 601, 0, 16, 33, 650
"d:\FIXXUP\Angular-FIXXP-\src\app\society\society.component.spec.ts", "TypeScript", 18, 0, 0, 0, 6, 24
"d:\FIXXUP\Angular-FIXXP-\src\app\society\society.component.ts", "TypeScript", 207, 0, 0, 6, 35, 248
"d:\FIXXUP\Angular-FIXXP-\src\app\societysearch\societysearch.component.css", "CSS", 0, 0, 16, 0, 4, 20
"d:\FIXXUP\Angular-FIXXP-\src\app\societysearch\societysearch.component.html", "HTML", 0, 50, 0, 0, 1, 51
"d:\FIXXUP\Angular-FIXXP-\src\app\societysearch\societysearch.component.spec.ts", "TypeScript", 18, 0, 0, 0, 6, 24
"d:\FIXXUP\Angular-FIXXP-\src\app\societysearch\societysearch.component.ts", "TypeScript", 20, 0, 0, 0, 9, 29
"d:\FIXXUP\Angular-FIXXP-\src\app\stamp-paper\stamp-paper.component.css", "CSS", 0, 0, 355, 465, 93, 913
"d:\FIXXUP\Angular-FIXXP-\src\app\stamp-paper\stamp-paper.component.html", "HTML", 0, 380, 0, 0, 16, 396
"d:\FIXXUP\Angular-FIXXP-\src\app\stamp-paper\stamp-paper.component.spec.ts", "TypeScript", 18, 0, 0, 0, 6, 24
"d:\FIXXUP\Angular-FIXXP-\src\app\stamp-paper\stamp-paper.component.ts", "TypeScript", 133, 0, 0, 0, 13, 146
"d:\FIXXUP\Angular-FIXXP-\src\app\statestatus\statestatus.component.css", "CSS", 0, 0, 0, 0, 1, 1
"d:\FIXXUP\Angular-FIXXP-\src\app\statestatus\statestatus.component.html", "HTML", 0, 24, 0, 0, 9, 33
"d:\FIXXUP\Angular-FIXXP-\src\app\statestatus\statestatus.component.spec.ts", "TypeScript", 18, 0, 0, 0, 6, 24
"d:\FIXXUP\Angular-FIXXP-\src\app\statestatus\statestatus.component.ts", "TypeScript", 35, 0, 0, 0, 11, 46
"d:\FIXXUP\Angular-FIXXP-\src\app\tickets\tickets.component.css", "CSS", 0, 0, 190, 866, 18, 1074
"d:\FIXXUP\Angular-FIXXP-\src\app\tickets\tickets.component.html", "HTML", 0, 502, 0, 17, 39, 558
"d:\FIXXUP\Angular-FIXXP-\src\app\tickets\tickets.component.spec.ts", "TypeScript", 18, 0, 0, 0, 6, 24
"d:\FIXXUP\Angular-FIXXP-\src\app\tickets\tickets.component.ts", "TypeScript", 133, 0, 0, 0, 14, 147
"d:\FIXXUP\Angular-FIXXP-\src\app\transactionhistory\transactionhistory.component.css", "CSS", 0, 0, 188, 1, 19, 208
"d:\FIXXUP\Angular-FIXXP-\src\app\transactionhistory\transactionhistory.component.html", "HTML", 0, 620, 0, 31, 20, 671
"d:\FIXXUP\Angular-FIXXP-\src\app\transactionhistory\transactionhistory.component.spec.ts", "TypeScript", 18, 0, 0, 0, 6, 24
"d:\FIXXUP\Angular-FIXXP-\src\app\transactionhistory\transactionhistory.component.ts", "TypeScript", 158, 0, 0, 0, 19, 177
"d:\FIXXUP\Angular-FIXXP-\src\app\update-promotion\update-promotion.component.css", "CSS", 0, 0, 555, 397, 133, 1085
"d:\FIXXUP\Angular-FIXXP-\src\app\update-promotion\update-promotion.component.html", "HTML", 0, 189, 0, 85, 47, 321
"d:\FIXXUP\Angular-FIXXP-\src\app\update-promotion\update-promotion.component.spec.ts", "TypeScript", 18, 0, 0, 0, 6, 24
"d:\FIXXUP\Angular-FIXXP-\src\app\update-promotion\update-promotion.component.ts", "TypeScript", 176, 0, 0, 0, 26, 202
"d:\FIXXUP\Angular-FIXXP-\src\app\user-kyc\user-kyc.component.css", "CSS", 0, 0, 194, 7, 44, 245
"d:\FIXXUP\Angular-FIXXP-\src\app\user-kyc\user-kyc.component.html", "HTML", 0, 58, 0, 0, 3, 61
"d:\FIXXUP\Angular-FIXXP-\src\app\user-kyc\user-kyc.component.spec.ts", "TypeScript", 18, 0, 0, 0, 6, 24
"d:\FIXXUP\Angular-FIXXP-\src\app\user-kyc\user-kyc.component.ts", "TypeScript", 28, 0, 0, 0, 5, 33
"d:\FIXXUP\Angular-FIXXP-\src\app\userkyc\userkyc.component.css", "CSS", 0, 0, 0, 0, 1, 1
"d:\FIXXUP\Angular-FIXXP-\src\app\userkyc\userkyc.component.html", "HTML", 0, 1, 0, 0, 1, 2
"d:\FIXXUP\Angular-FIXXP-\src\app\userkyc\userkyc.component.spec.ts", "TypeScript", 18, 0, 0, 0, 6, 24
"d:\FIXXUP\Angular-FIXXP-\src\app\userkyc\userkyc.component.ts", "TypeScript", 8, 0, 0, 0, 3, 11
"d:\FIXXUP\Angular-FIXXP-\src\app\usermanagement\usermanagement.component.css", "CSS", 0, 0, 171, 867, 15, 1053
"d:\FIXXUP\Angular-FIXXP-\src\app\usermanagement\usermanagement.component.html", "HTML", 0, 514, 0, 25, 31, 570
"d:\FIXXUP\Angular-FIXXP-\src\app\usermanagement\usermanagement.component.spec.ts", "TypeScript", 18, 0, 0, 0, 6, 24
"d:\FIXXUP\Angular-FIXXP-\src\app\usermanagement\usermanagement.component.ts", "TypeScript", 177, 0, 0, 0, 21, 198
"d:\FIXXUP\Angular-FIXXP-\src\app\view-due-amount\view-due-amount.component.css", "CSS", 0, 0, 11, 0, 1, 12
"d:\FIXXUP\Angular-FIXXP-\src\app\view-due-amount\view-due-amount.component.html", "HTML", 0, 68, 0, 0, 13, 81
"d:\FIXXUP\Angular-FIXXP-\src\app\view-due-amount\view-due-amount.component.spec.ts", "TypeScript", 18, 0, 0, 0, 6, 24
"d:\FIXXUP\Angular-FIXXP-\src\app\view-due-amount\view-due-amount.component.ts", "TypeScript", 39, 0, 0, 0, 11, 50
"d:\FIXXUP\Angular-FIXXP-\src\app\view-home-transaction\view-home-transaction.component.css", "CSS", 0, 0, 202, 7, 43, 252
"d:\FIXXUP\Angular-FIXXP-\src\app\view-home-transaction\view-home-transaction.component.html", "HTML", 0, 51, 0, 0, 20, 71
"d:\FIXXUP\Angular-FIXXP-\src\app\view-home-transaction\view-home-transaction.component.spec.ts", "TypeScript", 18, 0, 0, 0, 6, 24
"d:\FIXXUP\Angular-FIXXP-\src\app\view-home-transaction\view-home-transaction.component.ts", "TypeScript", 26, 0, 0, 0, 8, 34
"d:\FIXXUP\Angular-FIXXP-\src\app\view-kyc-manager\view-kyc-manager.component.css", "CSS", 0, 0, 255, 7, 51, 313
"d:\FIXXUP\Angular-FIXXP-\src\app\view-kyc-manager\view-kyc-manager.component.html", "HTML", 0, 120, 0, 3, 6, 129
"d:\FIXXUP\Angular-FIXXP-\src\app\view-kyc-manager\view-kyc-manager.component.spec.ts", "TypeScript", 18, 0, 0, 0, 6, 24
"d:\FIXXUP\Angular-FIXXP-\src\app\view-kyc-manager\view-kyc-manager.component.ts", "TypeScript", 45, 0, 0, 0, 16, 61
"d:\FIXXUP\Angular-FIXXP-\src\app\view-security-workers-kyc-doc\view-security-workers-kyc-doc.component.css", "CSS", 0, 0, 0, 0, 1, 1
"d:\FIXXUP\Angular-FIXXP-\src\app\view-security-workers-kyc-doc\view-security-workers-kyc-doc.component.html", "HTML", 0, 1, 0, 0, 0, 1
"d:\FIXXUP\Angular-FIXXP-\src\app\view-security-workers-kyc-doc\view-security-workers-kyc-doc.component.spec.ts", "TypeScript", 18, 0, 0, 0, 6, 24
"d:\FIXXUP\Angular-FIXXP-\src\app\view-security-workers-kyc-doc\view-security-workers-kyc-doc.component.ts", "TypeScript", 34, 0, 0, 0, 12, 46
"d:\FIXXUP\Angular-FIXXP-\src\app\view-security-workers-kyc\view-security-workers-kyc.component.css", "CSS", 0, 0, 255, 7, 51, 313
"d:\FIXXUP\Angular-FIXXP-\src\app\view-security-workers-kyc\view-security-workers-kyc.component.html", "HTML", 0, 60, 0, 15, 7, 82
"d:\FIXXUP\Angular-FIXXP-\src\app\view-security-workers-kyc\view-security-workers-kyc.component.spec.ts", "TypeScript", 18, 0, 0, 0, 6, 24
"d:\FIXXUP\Angular-FIXXP-\src\app\view-security-workers-kyc\view-security-workers-kyc.component.ts", "TypeScript", 30, 0, 0, 0, 13, 43
"d:\FIXXUP\Angular-FIXXP-\src\app\view-security-workers\view-security-workers.component.css", "CSS", 0, 0, 208, 7, 47, 262
"d:\FIXXUP\Angular-FIXXP-\src\app\view-security-workers\view-security-workers.component.html", "HTML", 0, 111, 0, 3, 10, 124
"d:\FIXXUP\Angular-FIXXP-\src\app\view-security-workers\view-security-workers.component.spec.ts", "TypeScript", 18, 0, 0, 0, 6, 24
"d:\FIXXUP\Angular-FIXXP-\src\app\view-security-workers\view-security-workers.component.ts", "TypeScript", 45, 0, 0, 0, 8, 53
"d:\FIXXUP\Angular-FIXXP-\src\app\view-society-logo\view-society-logo.component.css", "CSS", 0, 0, 0, 0, 1, 1
"d:\FIXXUP\Angular-FIXXP-\src\app\view-society-logo\view-society-logo.component.html", "HTML", 0, 1, 0, 0, 1, 2
"d:\FIXXUP\Angular-FIXXP-\src\app\view-society-logo\view-society-logo.component.spec.ts", "TypeScript", 18, 0, 0, 0, 6, 24
"d:\FIXXUP\Angular-FIXXP-\src\app\view-society-logo\view-society-logo.component.ts", "TypeScript", 34, 0, 0, 0, 14, 48
"d:\FIXXUP\Angular-FIXXP-\src\app\view-society-manager-kyc\view-society-manager-kyc.component.css", "CSS", 0, 0, 0, 0, 1, 1
"d:\FIXXUP\Angular-FIXXP-\src\app\view-society-manager-kyc\view-society-manager-kyc.component.html", "HTML", 0, 1, 0, 0, 0, 1
"d:\FIXXUP\Angular-FIXXP-\src\app\view-society-manager-kyc\view-society-manager-kyc.component.spec.ts", "TypeScript", 18, 0, 0, 0, 6, 24
"d:\FIXXUP\Angular-FIXXP-\src\app\view-society-manager-kyc\view-society-manager-kyc.component.ts", "TypeScript", 34, 0, 0, 0, 5, 39
"d:\FIXXUP\Angular-FIXXP-\src\app\view-ticket-workers-kyc-doc\view-ticket-workers-kyc-doc.component.css", "CSS", 0, 0, 0, 0, 1, 1
"d:\FIXXUP\Angular-FIXXP-\src\app\view-ticket-workers-kyc-doc\view-ticket-workers-kyc-doc.component.html", "HTML", 0, 1, 0, 0, 0, 1
"d:\FIXXUP\Angular-FIXXP-\src\app\view-ticket-workers-kyc-doc\view-ticket-workers-kyc-doc.component.spec.ts", "TypeScript", 18, 0, 0, 0, 6, 24
"d:\FIXXUP\Angular-FIXXP-\src\app\view-ticket-workers-kyc-doc\view-ticket-workers-kyc-doc.component.ts", "TypeScript", 34, 0, 0, 0, 8, 42
"d:\FIXXUP\Angular-FIXXP-\src\app\view-ticket-workers-kyc\view-ticket-workers-kyc.component.css", "CSS", 0, 0, 194, 7, 44, 245
"d:\FIXXUP\Angular-FIXXP-\src\app\view-ticket-workers-kyc\view-ticket-workers-kyc.component.html", "HTML", 0, 34, 0, 0, 5, 39
"d:\FIXXUP\Angular-FIXXP-\src\app\view-ticket-workers-kyc\view-ticket-workers-kyc.component.spec.ts", "TypeScript", 18, 0, 0, 0, 6, 24
"d:\FIXXUP\Angular-FIXXP-\src\app\view-ticket-workers-kyc\view-ticket-workers-kyc.component.ts", "TypeScript", 28, 0, 0, 0, 4, 32
"d:\FIXXUP\Angular-FIXXP-\src\app\view-ticket-workers\view-ticket-workers.component.css", "CSS", 0, 0, 194, 7, 44, 245
"d:\FIXXUP\Angular-FIXXP-\src\app\view-ticket-workers\view-ticket-workers.component.html", "HTML", 0, 98, 0, 3, 9, 110
"d:\FIXXUP\Angular-FIXXP-\src\app\view-ticket-workers\view-ticket-workers.component.spec.ts", "TypeScript", 18, 0, 0, 0, 6, 24
"d:\FIXXUP\Angular-FIXXP-\src\app\view-ticket-workers\view-ticket-workers.component.ts", "TypeScript", 36, 0, 0, 0, 8, 44
"d:\FIXXUP\Angular-FIXXP-\src\app\view-worker-transactions\view-worker-transactions.component.css", "CSS", 0, 0, 0, 0, 1, 1
"d:\FIXXUP\Angular-FIXXP-\src\app\view-worker-transactions\view-worker-transactions.component.html", "HTML", 0, 1, 0, 0, 1, 2
"d:\FIXXUP\Angular-FIXXP-\src\app\view-worker-transactions\view-worker-transactions.component.spec.ts", "TypeScript", 18, 0, 0, 0, 6, 24
"d:\FIXXUP\Angular-FIXXP-\src\app\view-worker-transactions\view-worker-transactions.component.ts", "TypeScript", 8, 0, 0, 0, 3, 11
"d:\FIXXUP\Angular-FIXXP-\src\app\view-workers-kyc\view-workers-kyc.component.css", "CSS", 0, 0, 0, 0, 1, 1
"d:\FIXXUP\Angular-FIXXP-\src\app\view-workers-kyc\view-workers-kyc.component.html", "HTML", 0, 1, 0, 0, 0, 1
"d:\FIXXUP\Angular-FIXXP-\src\app\view-workers-kyc\view-workers-kyc.component.spec.ts", "TypeScript", 18, 0, 0, 0, 6, 24
"d:\FIXXUP\Angular-FIXXP-\src\app\view-workers-kyc\view-workers-kyc.component.ts", "TypeScript", 36, 0, 0, 0, 5, 41
"d:\FIXXUP\Angular-FIXXP-\src\app\view-workers\view-workers.component.css", "CSS", 0, 0, 208, 7, 47, 262
"d:\FIXXUP\Angular-FIXXP-\src\app\view-workers\view-workers.component.html", "HTML", 0, 102, 0, 3, 12, 117
"d:\FIXXUP\Angular-FIXXP-\src\app\view-workers\view-workers.component.spec.ts", "TypeScript", 18, 0, 0, 0, 6, 24
"d:\FIXXUP\Angular-FIXXP-\src\app\view-workers\view-workers.component.ts", "TypeScript", 45, 0, 0, 0, 7, 52
"d:\FIXXUP\Angular-FIXXP-\src\app\viewaily-helper-doc\viewaily-helper-doc.component.css", "CSS", 0, 0, 0, 0, 1, 1
"d:\FIXXUP\Angular-FIXXP-\src\app\viewaily-helper-doc\viewaily-helper-doc.component.html", "HTML", 0, 1, 0, 0, 1, 2
"d:\FIXXUP\Angular-FIXXP-\src\app\viewaily-helper-doc\viewaily-helper-doc.component.spec.ts", "TypeScript", 18, 0, 0, 0, 6, 24
"d:\FIXXUP\Angular-FIXXP-\src\app\viewaily-helper-doc\viewaily-helper-doc.component.ts", "TypeScript", 8, 0, 0, 0, 3, 11
"d:\FIXXUP\Angular-FIXXP-\src\app\viewmanager\viewmanager.component.css", "CSS", 0, 0, 253, 37, 53, 343
"d:\FIXXUP\Angular-FIXXP-\src\app\viewmanager\viewmanager.component.html", "HTML", 0, 200, 0, 0, 8, 208
"d:\FIXXUP\Angular-FIXXP-\src\app\viewmanager\viewmanager.component.spec.ts", "TypeScript", 18, 0, 0, 0, 6, 24
"d:\FIXXUP\Angular-FIXXP-\src\app\viewmanager\viewmanager.component.ts", "TypeScript", 60, 0, 0, 0, 10, 70
"d:\FIXXUP\Angular-FIXXP-\src\app\viewuser\viewuser.component.css", "CSS", 0, 0, 202, 7, 43, 252
"d:\FIXXUP\Angular-FIXXP-\src\app\viewuser\viewuser.component.html", "HTML", 0, 97, 0, 0, 19, 116
"d:\FIXXUP\Angular-FIXXP-\src\app\viewuser\viewuser.component.spec.ts", "TypeScript", 18, 0, 0, 0, 6, 24
"d:\FIXXUP\Angular-FIXXP-\src\app\viewuser\viewuser.component.ts", "TypeScript", 61, 0, 0, 12, 4, 77
"d:\FIXXUP\Angular-FIXXP-\src\app\visitors-category\visitors-category.component.css", "CSS", 0, 0, 171, 866, 16, 1053
"d:\FIXXUP\Angular-FIXXP-\src\app\visitors-category\visitors-category.component.html", "HTML", 0, 330, 0, 613, 39, 982
"d:\FIXXUP\Angular-FIXXP-\src\app\visitors-category\visitors-category.component.spec.ts", "TypeScript", 18, 0, 0, 0, 6, 24
"d:\FIXXUP\Angular-FIXXP-\src\app\visitors-category\visitors-category.component.ts", "TypeScript", 177, 0, 0, 0, 16, 193
"d:\FIXXUP\Angular-FIXXP-\src\app\visitors-image\visitors-image.component.css", "CSS", 0, 0, 0, 0, 1, 1
"d:\FIXXUP\Angular-FIXXP-\src\app\visitors-image\visitors-image.component.html", "HTML", 0, 1, 0, 0, 0, 1
"d:\FIXXUP\Angular-FIXXP-\src\app\visitors-image\visitors-image.component.spec.ts", "TypeScript", 18, 0, 0, 0, 6, 24
"d:\FIXXUP\Angular-FIXXP-\src\app\visitors-image\visitors-image.component.ts", "TypeScript", 32, 0, 0, 0, 13, 45
"d:\FIXXUP\Angular-FIXXP-\src\app\worker-transaction-history\worker-transaction-history.component.css", "CSS", 0, 0, 386, 465, 131, 982
"d:\FIXXUP\Angular-FIXXP-\src\app\worker-transaction-history\worker-transaction-history.component.html", "HTML", 0, 75, 0, 0, 4, 79
"d:\FIXXUP\Angular-FIXXP-\src\app\worker-transaction-history\worker-transaction-history.component.spec.ts", "TypeScript", 18, 0, 0, 0, 6, 24
"d:\FIXXUP\Angular-FIXXP-\src\app\worker-transaction-history\worker-transaction-history.component.ts", "TypeScript", 108, 0, 0, 0, 9, 117
"d:\FIXXUP\Angular-FIXXP-\src\app\worker-transaction-update\worker-transaction-update.component.css", "CSS", 0, 0, 326, 393, 88, 807
"d:\FIXXUP\Angular-FIXXP-\src\app\worker-transaction-update\worker-transaction-update.component.html", "HTML", 0, 348, 0, 45, 17, 410
"d:\FIXXUP\Angular-FIXXP-\src\app\worker-transaction-update\worker-transaction-update.component.spec.ts", "TypeScript", 18, 0, 0, 0, 6, 24
"d:\FIXXUP\Angular-FIXXP-\src\app\worker-transaction-update\worker-transaction-update.component.ts", "TypeScript", 132, 0, 0, 0, 25, 157
"Total", "-", 15654, 27297, 21650, 33381, 8971, 106953